You can LOOK, TYPE, or move N S E W.

Number Lock w/ASCII and Puzzle (mod. from Bart Massey's Number Lock)
An Interactive Fiction by MRA
Release 1 / Serial number 120730 / Inform 7 build 6G60 (I6/v6.32 lib 6/12N) SD

Locked Room
You can see an exit door and a combination lock here.

>look
Locked Room
You can see an exit door and a combination lock here.

>look at lock
This lock has a numeric keypad and a display. You can type on it.

>type 8394
The keypad clicks merrily.

>look at display
A digital read-out printing the same message in a loop:

6734 576 07734

 0 
 | 
/ \ 
===============--------==== 
               ^^^^^^^^

A digital read-out printing the same message in a loop:

6734 576 07734

    0 
    | 
   // 
===============--------==== 
               ^^^^^^^^

A digital read-out printing the same message in a loop:

6734 576 07734

      0 
      | 
     / \ 
===============--------==== 
               ^^^^^^^^

A digital read-out printing the same message in a loop:

6734 576 07734

         0 
         | 
        // 
===============--------==== 
               ^^^^^^^^

A digital read-out printing the same message in a loop:

6734 576 07734

            0 
            | 
           / \ 
===============--------==== 
               ^^^^^^^^

A digital read-out printing the same message in a loop:

6734 576 07734

            
            
            
===============-|__|_x--==== 
               ^^^^^^^^

(x_x)

>type 6237
The keypad clicks merrily.

 0 
 | 
/ \ 
===============--------==== 
               ^^^^^^^^

    0 
    | 
   // 
===============--------==== 
               ^^^^^^^^

      0 
      | 
     / \ 
===============--------==== 
               ^^^^^^^^

         0 
         | 
        // 
===============--------==== 
               ^^^^^^^^

            0 
            | 
           / \ 
===============--------==== 
               ^^^^^^^^

                 0
                /-
              //
 
===============--------==== 
               ^^^^^^^^

                    0
                   |-
                  //
 
===============--------==== 
               ^^^^^^^^

                     0
                     |
                    //
===============--------==== 
               ^^^^^^^^

                        0
                        |
                       / \
===============--------==== 
               ^^^^^^^^

(^0^)

The display flashes and you hear a soft click.

>n
(first opening the exit door)

    *** You have escaped! ***

In that game you scored 1 out of a possible 1, in 6 turns.

Would you like to RESTART, RESTORE a saved game, QUIT or UNDO the last command?

>quit
[ The game has finished ]

* * *

>look
Locked Room
You can see an exit door and a combination lock here.

>help
That's not a verb I recognise.

I beg your pardon?

I beg your pardon?

>list
That's not a verb I recognise.

I beg your pardon?

* * *

>look
Locked Room
You can see an exit door and a combination lock here.

>type
I didn't understand that sentence.

I beg your pardon?

>type
I didn't understand that sentence.

* * *

You can LOOK, TYPE, or move N S E W.

Number Lock w/ASCII and Puzzle (mod. from Bart Massey's Number Lock)
An Interactive Fiction by MRA
Release 1 / Serial number 120730 / Inform 7 build 6G60 (I6/v6.32 lib 6/12N) SD

Locked Room
You can see an exit door and a combination lock here.

>6237
That's not a verb I recognise.

>type 6237
The keypad clicks merrily.

>type 604
The keypad clicks merrily.

The display flashes and you hear a soft click.

>type 6237
The keypad clicks merrily.

* * *

You can LOOK, TYPE, or move N S E W.

Number Lock w/ASCII and Puzzle (mod. from Bart Massey's Number Lock)
An Interactive Fiction by MRA
Release 1 / Serial number 120730 / Inform 7 build 6G60 (I6/v6.32 lib 6/12N) SD

Locked Room
You can see an exit door and a combination lock here.

>type 6237
The keypad clicks merrily.

 0 
 | 
/ \ 
===============--------==== 
               ^^^^^^^^

* * *

(^0^)

The display flashes and you hear a soft click.

>look at display
A digital read-out printing the same message in a loop:

6734 576 07734

 0 
 | 
/ \ 
===============--------==== 
               ^^^^^^^^

* * *

(x_x)

>604
That's not a verb I recognise.

>type 604
The keypad clicks merrily.

The display flashes and you hear a soft click.

* * *

                 0
                /-
              //
 
===============--------==== 
               ^^^^^^^^

                     0
                    |-
                   //
 
===============--------==== 
               ^^^^^^^^

                     0
                     |
                    //
===============--------==== 
               ^^^^^^^^

* * *

You can LOOK, TYPE, or move N S E W.

Number Lock w/ASCII and Puzzle (mod. from Bart Massey's Number Lock)
An Interactive Fiction by MRA
Release 1 / Serial number 120730 / Inform 7 build 6G60 (I6/v6.32 lib 6/12N) SD

Locked Room
You can see an exit door and a combination lock here.

>type 123
The keypad clicks merrily.

>type 604
The keypad clicks merrily.

The display flashes and you hear a soft click.

>type 6237
The keypad clicks merrily.

The display flashes and you hear a soft click.

>type 555
The keypad clicks merrily.

>look
Locked Room
You can see an exit door and a combination lock here.

* * *

You can LOOK, TYPE, or move N S E W.

Number Lock w/ASCII and Puzzle (mod. from Bart Massey's Number Lock)
An Interactive Fiction by MRA
Release 1 / Serial number 120730 / Inform 7 build 6G60 (I6/v6.32 lib 6/12N) SD

Locked Room
You can see an exit door and a combination lock here.

>look at display
A digital read-out printing the same message in a loop:

6734 576 07734

 0 
 | 
/ \ 
===============--------==== 
               ^^^^^^^^

* * *

A digital read-out printing the same message in a loop:

6734 576 07734

            
            
            
===============-|__|_x--==== 
               ^^^^^^^^

A digital read-out printing the same message in a loop:

6734 576 07734

(x_x)

* * *

A digital read-out printing the same message in a loop:

6734 576 07734

            0 
            | 
           / \ 
===============--------==== 
               ^^^^^^^^

A digital read-out printing the same message in a loop:

6734 576 07734

            
            
            
===============-|__|_x-==== 
               ^^^^^^^^

(x_x)

* * *

>604
That's not a verb I recognise.

>type 604
The keypad clicks merrily.

 0 
 | 
/ \ 
===============--------==== 
               ^^^^^^^^

    0 
    | 
   // 
===============--------==== 
               ^^^^^^^^

* * *

(^0^)

The display flashes and you hear a soft click.

>quit
Are you sure you want to quit?

>y
[ The game has finished ]

* * *

(x_x)

>type 604
The keypad clicks merrily.

 0 
 | 
/ \ 
===============--------==== 
               ^^^^^^^^

* * *

(^0^)

The display flashes and you hear a soft click.

>look at display
(^0^)

>look at display
(^0^)

I beg your pardon?

>n
(first opening the exit door)

    *** You have escaped! ***

In that game you scored 1 out of a possible 1, in 5 turns.

Would you like to RESTART, RESTORE a saved game, QUIT or UNDO the last command?

>quit
[ The game has finished ]

* * *

You can LOOK, TYPE, or move N S E W.

Number Lock w/ASCII and Puzzle (mod. from Bart Massey's Number Lock)
An Interactive Fiction by MRA
Release 1 / Serial number 120730 / Inform 7 build 6G60 (I6/v6.32 lib 6/12N) SD

Locked Room
You can see an exit door and a combination lock here.

>look at displau
You can't see any such thing.

>look at displau
You can't see any such thing.

>look at display
A digital read-out printing the same message in a loop:

6734 576 07734

 0 
 | 
/ \ 
================--------==== 
                ^^^^^^^^

     0 
     | 
    // 
================--------==== 
                ^^^^^^^^

       0 
       | 
      / \ 
================--------==== 
                ^^^^^^^^

          0 
          | 
         // 
================--------==== 
                ^^^^^^^^

* * *

You can LOOK, TYPE, or move N S E W.

Number Lock w/ASCII and Puzzle (mod. from Bart Massey's Number Lock)
An Interactive Fiction by MRA
Release 1 / Serial number 120730 / Inform 7 build 6G60 (I6/v6.32 lib 6/12N) SD

Locked Room
You can see an exit door and a combination lock here.

>type 604
The keypad clicks merrily.

 0 
 | 
/ \ 
===============--------==== 
               ^^^^^^^^

* * *

You can LOOK, TYPE, or move N S E W.

Number Lock w/ASCII and Puzzle (mod. from Bart Massey's Number Lock)
An Interactive Fiction by MRA
Release 1 / Serial number 120730 / Inform 7 build 6G60 (I6/v6.32 lib 6/12N) SD

Locked Room
You can see an exit door and a combination lock here.

>look at lock
This lock has a numeric keypad and a display. You can LOOK at the display, and TYPE numbers on the keypad. (^0^)

>look at display
A digital read-out printing the same message in a loop:

6734 576 07734

 0 
 | 
/ \ 
===============--------==== 
               ^^^^^^^^

* * *

(^0^)

The display flashes and you hear a soft click.

>exit
But you aren't in anything at the moment.

I beg your pardon?

>uit
That's not a verb I recognise.

>quit
Are you sure you want to quit?

* * *

(^0^)

The display flashes and you hear a soft click.

>look at lock
This lock has a numeric keypad and a display. You can LOOK at the display, and TYPE numbers on the keypad. (^0^)

>look at display
(^0^)

* * *

You can LOOK, TYPE, or move N S E W.

Number Lock w/ASCII and Puzzle (mod. from Bart Massey's Number Lock)
An Interactive Fiction by MRA
Release 1 / Serial number 120730 / Inform 7 build 6G60 (I6/v6.32 lib 6/12N) SD

Locked Room
You can see an exit door and a combination lock here.

>quit
Are you sure you want to quit?

>y\\
Please answer yes or no.

>yes
[ The game has finished ]

* * *

You can LOOK, TYPE, or move N S E W.

Number Lock w/ASCII and Puzzle (mod. from Bart Massey's Number Lock)
An Interactive Fiction by MRA
Release 1 / Serial number 120730 / Inform 7 build 6G60 (I6/v6.32 lib 6/12N) SD

Locked Room
You can see an exit door and a combination lock here.

>type 1262374584
The keypad clicks merrily.

I beg your pardon?

* * *

You can LOOK, TYPE, or move N S E W.

Number Lock w/ASCII and Puzzle (mod. from Bart Massey's Number Lock)
An Interactive Fiction by MRA
Release 1 / Serial number 120730 / Inform 7 build 6G60 (I6/v6.32 lib 6/12N) SD

Locked Room
You can see an exit door and a combination lock here.

>typing
That's not a verb I recognise.

I beg your pardon?

>type 0
You can type a NUMBER.

* * *

You can LOOK, TYPE, or move N S E W.

Number Lock w/ASCII and Puzzle (mod. from Bart Massey's Number Lock)
An Interactive Fiction by MRA
Release 1 / Serial number 120730 / Inform 7 build 6G60 (I6/v6.32 lib 6/12N) SD

Locked Room
You can see an exit door and a combination lock here.

>type
I didn't understand that sentence.

>type 0
*** Run-time problem P59: You can't implicitly repeat through the values of this kind: a problem arising from a description which started out here - "Instead of typing when there is no number".

The keypad clicks merrily.

* * *

You can LOOK, TYPE, or move N S E W.

Number Lock w/ASCII and Puzzle (mod. from Bart Massey's Number Lock)
An Interactive Fiction by MRA
Release 1 / Serial number 120730 / Inform 7 build 6G60 (I6/v6.32 lib 6/12N) SD

Locked Room
You can see an exit door and a combination lock here.

>type 4
The keypad clicks merrily.